
R    1500 1500
NO      ./textures/colorstone     

SO      ./textures/bluestone.xpm   

WE      ./textures/greystone.xpm     
EA      ./textures/redbrick.xpm

S       ./textures/sp.xpm

F   255,0,0

C   255,255,255




  1111111111111
 10000000000001
10000000000001111111111
11111000000000000000001
     11111000000000011111111
        100000000001
        100000000001     111111
        11111111000111111120021
        111111110000000000000011111111 
                111111100000000000000111111
              110000000000000000000001
    111111111100000000000000111111111111111111
    1000000000000000000000001
    1000000000000000000000001
    1000000111111111111110011 
    10000001            10001
    1000000011111111    10001
    10000000000000001111110001
    10011111111110000000000001
    1001        11111111111001
    1001                  1001
    1001                111001   11111111111111111111
    1011                10000111110000000000000000001111111111111111111111111111
    1001                100000000000000000000000000000000000000000000000000000001
    1001                100011111111111111111111111111111111111111111111111111111
    10001               11111
    100001
    1110001
    10000001
1111000000001
1000000000001
1000000000001
1000000000001
100000S000001    
1000000000001
1000000000001
1200022222221
1222222222221
1222220022221
1202222220221
1111111111111