

   

R     1920 1080



NO      ./textures/colorstone.xpm

SO ./textures/bluestone.xpm






WE ./textures/greystone.xpm
EA ./textures/redbrick.xpm




S ./textures/barrel.xpm



F    228,0,106


C       127,0,255




1111111111111111111111111
1000000000110000000000001
1011000001110000002000001
1001000000000000000000001
1111111110110000011100001
100000000011000001110111111111111

11110111111111011100000010001
11110111111111011101010010001
11000000110101011100000010001
10002000000000001100000010001
10000000000000001101010010001
1100N0011101010111110111100111
11110111 1110101 101111010001
11111111 1111111 111111111111









    


