R    1920 1080
NO      ./textures/colorstone.xpm
SO ./textures/bluestone.xpm
WE ./textures/greystone.xpm
EA ./textures/wood.xpm

S ./textures/barrel.xpm
F    255,248,220
C       135,206,250




  



            
        1111111111111111111111111
        1000000000110000000002021
111111111111111111111111111111111
101100000111000000000000111  
1001000000000020002000001
1111111110110000011100001
10000000001100000111011111111111
11110111111111011100000010001
11110111111111011101010012201
11000000110101011100000010001          
10000000000000001100000010001
10000000000000001101010010N01           
1100000111010001111101111000111
11110111 1110001 101111010001
11111111 1111111 111111111111



