R    1920 1080
NO      ./textures/colorstone.xpm
SO ./textures/bluestone.xpm
WE ./textures/greystone.xpm
EA ./textures/wood.xpm

S ./textures/barrel.xpm
F    255,248,220
C       135,206,250




  



            
111111111111111
100000000000001
100000000000001
100000000N00001
100000000000001
100000000000001
111111111111111

