R    1920 1080





NO      ./textures/colorstone.xpm

SO ./textures/bluestone.xpm






WE ./textures/greystone.xpm
EA ./textures/redbrick.xpm




S ./textures/barrel.xpm



F    228,0,106


C       127,0,255


  



            
11111111111
10000100001
10000N00001
10000000001
11111111111

