R  555 555



NO            ./textures/colorstone

SO ./textures/bluestone.xpm

WE ./textures/greystone.xpm



EA ./textures/redbrick.xpm




S ./textures/barrel.xpm


F    228,0,106


C       255,255,28



   
                                      111
                                     10001
        11111111111111111111          101           11111111111111111111
    111100000000000000000000111111111110111111111111000000000000000000001111
11110000000000000000000000000000000000000000000000000000000000000000000000001111
    111100000000000000000000111111111100011111111111000000000000000000001111
        11111111202111111111          101           11111111202111111111
                101                   101                   101
                101                   101                   101
                101                   101                   101
             111202111                101                111202111
            10000000001               101               10000000001
             111202111                101                111202111
                101                   101                   101
                101                   101                   101
                101                   101                   101
                10011111111111111111112021111111111111111111001
                10000000000000000000000N00000000000000000000001
                 111111111111111111111101111111111111111111111
                                      101
                                      101
                                      101
                                      101
                                     12021
                                    1000001
                                     11011
                                      101
                                      111