R     1920 1000
NO      ./textures/colorstone
SO ./textures/bluestone.xpm
WE ./textures/greystone.xpm
EA ./textures/redbrick.xpm
S ./textures/barrel.xpm
F    228,0,106
C       127,0,255

        1111111111111111111111111
        1000000000000000000000001

        101100000020000001000000111
        1001000000000000000000001
111111111011000000000000000010001
100000000000000000000111110111111
11110111111111011100000010001
11110111111111011101010010001
11000000110101011100000010001
10000000000000001100000010001
10000000000000001101010010001
1100N00111010001111101111000111
11110111 1110001 101111010001
11111111 1111111 111111111111