R 1000 1000


F  0,255,0
C F  255,0,0
S ./textures/barrel.xpm
NO   ./textures/colorstone
SO ./textures/bluestone.xpm
WE ./textures/greystone.xpm
EA ./textures/barrel.xpm

        1111111111111111111111111
        1000000000000000000000001
        101100000020000001000000111
        1001000000000000000000001
111111111011000000000000000010001
100000000000000000000111110111111
11110111111111011100000010001
11110111111111011101010010001
111111111 11111111111111111111
11111111111111111111111111111
11000000110101011100000010001
10000000000000001100000010001
10000000000000001101010010001
1100N20111010001111101111000111
11110111 1110001 101111010001
11111111 1111111 111111111111