 
R     1890 1080



NO      ./textures/colorstone

SO ./textures/bluestone.xpm






WE ./textures/greystone.xpm
EA ./textures/redbrick.xpm




S ./textures/north.xpm



F    228,0,106


C       127,8,255




 1111111111111
 12222222222221
12222222222221111111111
11111222222222222222221
     11111222222222211111111
        122222222221
        122222222221     111111
        11111111222111111122221
        111111112222222222222211111111
                111111122222222222222111111
              11222222E222222222222221
    111111111122222222222222111111111111111111
    1222222222222222222222221
    1222222222222222222222221
    1222222111111111111112211
    12222221            12221
    1222222211111111    122221
    12222222222222221111112221
    12211111111112222222222221
    1221        11111111111221
    1221                  1221
    1221                111221   11111111111111111111
    1211                12222111112222222222222222221111111111111111111111111111
    1221                122222222222222222222222222222222222222222222222222222221
    1221                122211111111111111111111111111111111111111111111111111111
    12221               11111
    122221
    1112221
    12222221
1111222222221
1222222222221
1222222222221
1222222222221
1222222222221
1222222222221
1222222222221
1222222222221
1222222222221
1222222222221
1222222222221
1111111111111