

R      1920   1080  

NO   ./textures/north.xpm

SO   ./textures/greystone.xpm

WE     ./textures/bluestone.xpm



EA          ./textures/wood.xpm


S   ./textures/barrel.xpm

F      255,248,220          



C               125,206,250


11111
10001
100S1 
11111
            